version,added,durationms,rate,accsize,cumulsize
0,30035245,463888,64,744743832,30035245
1,16259671,1851082,8,1307036253,46294916
2,14904445,7881537,1,1949972492,61199361
3,14685341,10864927,1,2597058407,75884702
4,17090306,14056601,1,3113593241,92975008
5,13221294,16965158,0,3774890743,106196302
6,14825275,18796199,0,4448988309,121021577
7,15889687,21801280,0,5057640454,136911264
8,15147259,26077432,0,5732859624,152058523
9,13489672,29032952,0,6297431351,165548195